111111
1CCC11
1PCC11
1CEC11
111111