11111111111
11110C01111
11110001111
11110001111
11000001111
1000000V001
1C0V0P0V0E1
10000V00001
1111V001111
1111CCC1111
11110001111
11111111111