


11111
10EV1
101V1
1P1V1
11111



