1111111111111111111111111111111111111111111111
1VCCCCCCCCCCCCCCCCCCCCCCCCCCCCCCCCCCCCCCCCCCC1
1C111C111111111C111111111111111C11111111C111C1
1C111C111111111C111111111111111C11111111C111C1
1CCCCC111111111CCCCCCCCCCCCCCCCCCCCCCCCCC111C1
11111C111CCCCCCC1111111C11111110000000E00111C1
11111C111C11111C1111111C11111110111001110111C1
11111C111C11111C1100011C11000110100000010111C1
1PCCCC111CCV111C110V011C110V0110100CC0010111C1
11111C111111111C1100011C11000110111111110111C1
11111C111111111C1111111C11111110000000000111C1
1111111111111111111111111111111111111111111111