1111111111111111111
1CCCCCCCCCCCCCCCCC1
1C111111C1C111111C1
1C1CCCCCC1CCCCCCEC1
1CCC1C11CCC1101CCC1
11111C1111111011111
1PCCCC11111110000V1
1011111111111111111
1CCCCCCCCCCCCCCCCC1
1C111111C1C111111C1
1111111111111111111