1111111111111111111111
1V1V1V1V111111V1V1V1V1
11111111CCCCCC11111111
1PCCCCCCCCCCCCCCCCCCE1
11111111CCCCCC11111111
1V1V1V1V111111V1V1V1V1
1111111111111111111111